110000000000000000000000000011
110000000000000000000000000011
110011001100110011001100110011
110011001100110011001100110011
110011001100110011001100110011
110011001100110011001100110011
110011001100112211001100110011
110011001100112211001100110011
110011001100110011001100110011
110011001100000000001100110011
110011001100000000001100110011
110000000000110011000000000011
110000000000110011000000000011
111100111100000000001111001111
112200111100000000001111002211
110000000000110011000000000011
110000000000111111000000000011
110011001100111111001100110011
110011001100110011001100110011
110011001100110011001100110011
110011001100110011001100110011
110011001100000000001100110011
110011001100000000001100110011
110011001100011110001100110011
110011001100010010001100110011
110011001100010010001100110011
111111111111111111111111111111
111111111111111111111111111111